Day,Weekday,Glider flights,Avg Duration,Cross Countrys,Tows,Winches,Other Flights,Avg Duration,Cross Country
2020-09-10,Thu,0,0,0,0,0,0,0,0
2020-09-11,Fri,0,0,0,0,0,0,0,0
2020-09-12,Sat,0,0,0,0,0,0,0,0
2020-09-13,Sun,0,0,0,0,0,0,0,0
2020-09-14,Mon,0,0,0,0,0,0,0,0
2020-09-15,Tue,18,1810.2222222222222,9,0,18,0,0,0
2020-09-16,Wed,15,699.4285714285714,8,0,15,7,3934.6666666666665,4
2020-09-17,Thu,30,2336.3,20,1,29,15,741.8571428571429,8
2020-09-18,Fri,15,1327.5,7,2,13,10,775.6666666666666,7
2020-09-19,Sat,27,639.35,7,0,27,4,0,4
2020-09-20,Sun,10,1243.6,0,1,9,7,1626.0,4
2020-09-21,Mon,13,554.875,5,0,13,7,8714.0,6
2020-09-22,Tue,20,701.25,4,0,20,3,6474.5,1
2020-09-23,Wed,0,0,0,0,0,0,0,0
2020-09-24,Thu,4,2097.0,3,0,4,3,2135.3333333333335,0
2020-09-25,Fri,0,0,0,0,0,0,0,0
2020-09-26,Sat,2,622.0,0,2,0,2,634.5,0
2020-09-27,Sun,0,0,0,0,0,0,0,0
2020-09-28,Mon,15,771.2222222222222,6,1,14,8,4566.5,2
2020-09-29,Tue,11,441.0,10,1,10,7,570.6666666666666,4
2020-09-30,Wed,0,0,0,0,0,0,0,0
2020-10-01,Thu,22,1650.3333333333333,7,0,22,6,629.0,5
2020-10-02,Fri,0,0,0,0,0,0,0,0
2020-10-03,Sat,0,0,0,0,0,0,0,0
2020-10-04,Sun,0,0,0,0,0,0,0,0
2020-10-05,Mon,1,2212.0,0,0,1,0,0,0
2020-10-06,Tue,6,1118.8333333333333,0,5,1,5,524.8,0
2020-10-07,Wed,43,607.3783783783783,6,9,34,9,712.5,1
2020-10-08,Thu,9,1215.625,1,5,4,9,647.8888888888889,0
2020-10-09,Fri,28,853.35,8,3,25,4,655.0,0
2020-10-10,Sat,25,572.25,1,2,23,6,775.2,1
2020-10-11,Sun,44,1196.2682926829268,3,17,27,24,1976.0833333333333,0
2020-10-12,Mon,0,0,0,0,0,2,0,2
2020-10-13,Tue,0,0,0,0,0,0,0,0
2020-10-14,Wed,24,796.3809523809524,3,3,21,3,681.3333333333334,0
2020-10-15,Thu,3,1996.0,2,0,3,1,3073.0,0
2020-10-16,Fri,0,0,0,0,0,0,0,0
2020-10-17,Sat,5,1927.6,0,0,5,6,1134.5,4
2020-10-18,Sun,26,389.15384615384613,0,0,26,5,908.6666666666666,2
2020-10-19,Mon,1,2836.0,0,0,1,0,0,0
2020-10-20,Tue,0,0,0,0,0,0,0,0
2020-10-21,Wed,0,0,0,0,0,0,0,0
2020-10-22,Thu,4,1801.75,0,0,4,2,10619.5,0
2020-10-23,Fri,0,0,0,0,0,0,0,0
2020-10-24,Sat,0,0,0,0,0,0,0,0
2020-10-25,Sun,0,0,0,0,0,0,0,0
2020-10-26,Mon,17,318.47058823529414,0,0,17,1,0,1
2020-10-27,Tue,0,0,0,0,0,0,0,0
2020-10-28,Wed,4,1198.6666666666667,1,3,1,7,583.5,3
2020-10-29,Thu,0,0,0,0,0,0,0,0
2020-10-30,Fri,0,0,0,0,0,0,0,0
2020-10-31,Sat,0,0,0,0,0,0,0,0
2020-11-01,Sun,0,0,0,0,0,0,0,0
2020-11-02,Mon,0,0,0,0,0,0,0,0
2020-11-03,Tue,0,0,0,0,0,0,0,0
2020-11-04,Wed,0,0,0,0,0,0,0,0
2020-11-05,Thu,0,0,0,0,0,0,0,0
2020-11-06,Fri,0,0,0,0,0,0,0,0
2020-11-07,Sat,0,0,0,0,0,0,0,0
2020-11-08,Sun,0,0,0,0,0,0,0,0
2020-11-09,Mon,0,0,0,0,0,0,0,0
2020-11-10,Tue,0,0,0,0,0,0,0,0
2020-11-11,Wed,0,0,0,0,0,0,0,0
2020-11-12,Thu,0,0,0,0,0,0,0,0
2020-11-13,Fri,0,0,0,0,0,0,0,0
2020-11-14,Sat,0,0,0,0,0,0,0,0
2020-11-15,Sun,0,0,0,0,0,0,0,0
2020-11-16,Mon,0,0,0,0,0,0,0,0
2020-11-17,Tue,0,0,0,0,0,0,0,0
2020-11-18,Wed,0,0,0,0,0,0,0,0
2020-11-19,Thu,0,0,0,0,0,0,0,0
2020-11-20,Fri,0,0,0,0,0,0,0,0
2020-11-21,Sat,0,0,0,0,0,0,0,0
2020-11-22,Sun,0,0,0,0,0,0,0,0
2020-11-23,Mon,0,0,0,0,0,0,0,0
2020-11-24,Tue,0,0,0,0,0,0,0,0
2020-11-25,Wed,0,0,0,0,0,0,0,0
2020-11-26,Thu,0,0,0,0,0,0,0,0
2020-11-27,Fri,0,0,0,0,0,0,0,0
2020-11-28,Sat,0,0,0,0,0,0,0,0
2020-11-29,Sun,0,0,0,0,0,0,0,0
2020-11-30,Mon,0,0,0,0,0,0,0,0
2020-12-01,Tue,0,0,0,0,0,0,0,0
2020-12-02,Wed,0,0,0,0,0,1,0,1
2020-12-03,Thu,0,0,0,0,0,0,0,0
2020-12-04,Fri,0,0,0,0,0,0,0,0
2020-12-05,Sat,0,0,0,0,0,0,0,0
2020-12-06,Sun,0,0,0,0,0,0,0,0
2020-12-07,Mon,0,0,0,0,0,0,0,0
2020-12-08,Tue,0,0,0,0,0,0,0,0
2020-12-09,Wed,0,0,0,0,0,0,0,0
2020-12-10,Thu,0,0,0,0,0,0,0,0
2020-12-11,Fri,0,0,0,0,0,0,0,0
2020-12-12,Sat,0,0,0,0,0,0,0,0
2020-12-13,Sun,0,0,0,0,0,0,0,0
2020-12-14,Mon,0,0,0,0,0,0,0,0
2020-12-15,Tue,0,0,0,0,0,0,0,0
2020-12-16,Wed,0,0,0,0,0,0,0,0
2020-12-17,Thu,0,0,0,0,0,0,0,0
2020-12-18,Fri,0,0,0,0,0,0,0,0
2020-12-19,Sat,0,0,0,0,0,0,0,0
2020-12-20,Sun,0,0,0,0,0,0,0,0
2020-12-21,Mon,0,0,0,0,0,0,0,0
2020-12-22,Tue,0,0,0,0,0,0,0,0
2020-12-23,Wed,0,0,0,0,0,0,0,0
2020-12-24,Thu,0,0,0,0,0,0,0,0
2020-12-25,Fri,0,0,0,0,0,0,0,0
2020-12-26,Sat,0,0,0,0,0,0,0,0
2020-12-27,Sun,0,0,0,0,0,0,0,0
2020-12-28,Mon,0,0,0,0,0,0,0,0
2020-12-29,Tue,0,0,0,0,0,0,0,0
2020-12-30,Wed,0,0,0,0,0,0,0,0
2020-12-31,Thu,0,0,0,0,0,0,0,0
2021-01-01,Fri,0,0,0,0,0,0,0,0
2021-01-02,Sat,0,0,0,0,0,0,0,0
2021-01-03,Sun,0,0,0,0,0,0,0,0
2021-01-04,Mon,0,0,0,0,0,0,0,0
2021-01-05,Tue,0,0,0,0,0,0,0,0
2021-01-06,Wed,0,0,0,0,0,0,0,0
2021-01-07,Thu,0,0,0,0,0,0,0,0
2021-01-08,Fri,0,0,0,0,0,0,0,0
2021-01-09,Sat,0,0,0,0,0,0,0,0
2021-01-10,Sun,0,0,0,0,0,0,0,0
2021-01-11,Mon,0,0,0,0,0,0,0,0
2021-01-12,Tue,0,0,0,0,0,0,0,0
2021-01-13,Wed,0,0,0,0,0,0,0,0
2021-01-14,Thu,0,0,0,0,0,0,0,0
2021-01-15,Fri,0,0,0,0,0,0,0,0
2021-01-16,Sat,0,0,0,0,0,0,0,0
2021-01-17,Sun,0,0,0,0,0,0,0,0
2021-01-18,Mon,0,0,0,0,0,0,0,0
2021-01-19,Tue,0,0,0,0,0,0,0,0
2021-01-20,Wed,0,0,0,0,0,0,0,0
2021-01-21,Thu,0,0,0,0,0,0,0,0
2021-01-22,Fri,0,0,0,0,0,0,0,0
2021-01-23,Sat,0,0,0,0,0,0,0,0
2021-01-24,Sun,0,0,0,0,0,0,0,0
2021-01-25,Mon,0,0,0,0,0,0,0,0
2021-01-26,Tue,0,0,0,0,0,0,0,0
2021-01-27,Wed,0,0,0,0,0,0,0,0
2021-01-28,Thu,0,0,0,0,0,0,0,0
2021-01-29,Fri,0,0,0,0,0,0,0,0
2021-01-30,Sat,0,0,0,0,0,0,0,0
2021-01-31,Sun,0,0,0,0,0,0,0,0
2021-02-01,Mon,0,0,0,0,0,0,0,0
2021-02-02,Tue,0,0,0,0,0,0,0,0
2021-02-03,Wed,0,0,0,0,0,0,0,0
2021-02-04,Thu,0,0,0,0,0,0,0,0
2021-02-05,Fri,0,0,0,0,0,0,0,0
2021-02-06,Sat,0,0,0,0,0,0,0,0
2021-02-07,Sun,0,0,0,0,0,0,0,0
2021-02-08,Mon,0,0,0,0,0,0,0,0
2021-02-09,Tue,0,0,0,0,0,0,0,0
2021-02-10,Wed,0,0,0,0,0,0,0,0
2021-02-11,Thu,0,0,0,0,0,0,0,0
2021-02-12,Fri,0,0,0,0,0,0,0,0
2021-02-13,Sat,0,0,0,0,0,0,0,0
2021-02-14,Sun,0,0,0,0,0,0,0,0
2021-02-15,Mon,0,0,0,0,0,1,2606.0,0
2021-02-16,Tue,0,0,0,0,0,0,0,0
2021-02-17,Wed,0,0,0,0,0,0,0,0
2021-02-18,Thu,0,0,0,0,0,0,0,0
2021-02-19,Fri,0,0,0,0,0,0,0,0
2021-02-20,Sat,0,0,0,0,0,0,0,0
2021-02-21,Sun,0,0,0,0,0,0,0,0
2021-02-22,Mon,0,0,0,0,0,0,0,0
2021-02-23,Tue,0,0,0,0,0,0,0,0
2021-02-24,Wed,0,0,0,0,0,0,0,0
2021-02-25,Thu,0,0,0,0,0,0,0,0
2021-02-26,Fri,0,0,0,0,0,0,0,0
2021-02-27,Sat,0,0,0,0,0,0,0,0
2021-02-28,Sun,0,0,0,0,0,0,0,0
2021-03-01,Mon,0,0,0,0,0,0,0,0
2021-03-02,Tue,0,0,0,0,0,0,0,0
2021-03-03,Wed,0,0,0,0,0,0,0,0
2021-03-04,Thu,0,0,0,0,0,0,0,0
2021-03-05,Fri,0,0,0,0,0,0,0,0
2021-03-06,Sat,0,0,0,0,0,7,538.4285714285714,0
2021-03-07,Sun,0,0,0,0,0,10,554.7,0
2021-03-08,Mon,0,0,0,0,0,0,0,0
2021-03-09,Tue,0,0,0,0,0,0,0,0
2021-03-10,Wed,0,0,0,0,0,0,0,0
2021-03-11,Thu,0,0,0,0,0,0,0,0
2021-03-12,Fri,0,0,0,0,0,0,0,0
2021-03-13,Sat,0,0,0,0,0,0,0,0
2021-03-14,Sun,0,0,0,0,0,0,0,0
2021-03-15,Mon,0,0,0,0,0,0,0,0
2021-03-16,Tue,0,0,0,0,0,0,0,0
2021-03-17,Wed,0,0,0,0,0,0,0,0
2021-03-18,Thu,0,0,0,0,0,0,0,0
2021-03-19,Fri,0,0,0,0,0,0,0,0
2021-03-20,Sat,4,861.5,0,4,0,5,528.8,0
2021-03-21,Sun,0,0,0,0,0,2,0,2
2021-03-22,Mon,0,0,0,0,0,0,0,0
2021-03-23,Tue,0,0,0,0,0,0,0,0
2021-03-24,Wed,5,1861.8,0,4,1,6,439.0,2
2021-03-25,Thu,0,0,0,0,0,0,0,0
2021-03-26,Fri,0,0,0,0,0,0,0,0
2021-03-27,Sat,0,0,0,0,0,0,0,0
2021-03-28,Sun,0,0,0,0,0,0,0,0
2021-03-29,Mon,0,0,0,0,0,0,0,0
2021-03-30,Tue,20,1129.1052631578948,1,7,13,21,876.2666666666667,6
2021-03-31,Wed,23,2033.7826086956522,0,7,16,16,1788.2307692307693,3
2021-04-01,Thu,0,0,0,0,0,0,0,0
2021-04-02,Fri,1,4036.0,0,0,1,8,1339.8333333333333,2
2021-04-03,Sat,6,1432.0,3,4,2,5,471.5,1
2021-04-04,Sun,4,1756.0,3,1,3,7,693.8,2
2021-04-05,Mon,0,0,0,0,0,1,4818.0,0
2021-04-06,Tue,1,4373.0,0,1,0,5,3198.6,0
2021-04-07,Wed,18,5172.117647058823,1,7,11,18,3669.8571428571427,4
2021-04-08,Thu,0,0,0,0,0,2,0,2
2021-04-09,Fri,0,0,0,0,0,0,0,0
2021-04-10,Sat,0,0,0,0,0,0,0,0
2021-04-11,Sun,5,3908.4,0,5,0,10,1724.7142857142858,3
2021-04-12,Mon,44,2396.2954545454545,0,15,29,34,1431.7037037037037,7
2021-04-13,Tue,17,6222.846153846154,4,11,6,25,1882.952380952381,4
2021-04-14,Wed,41,2544.439024390244,0,16,25,31,2581.962962962963,4
2021-04-15,Thu,8,4294.5,0,1,7,7,9270.5,5
2021-04-16,Fri,8,4648.25,0,5,3,14,668.1666666666666,2
2021-04-17,Sat,46,2597.3260869565215,0,10,36,21,2078.0625,5
2021-04-18,Sun,38,1729.7567567567567,1,15,23,21,993.05,1
2021-04-19,Mon,9,6334.5,1,8,1,16,1461.0,4
2021-04-20,Tue,12,11609.7,2,1,11,7,6727.666666666667,4
2021-04-21,Wed,30,813.7,0,0,30,1,9016.0,0
2021-04-22,Thu,17,1877.5294117647059,0,11,6,26,1356.16,1
2021-04-23,Fri,6,4106.0,2,4,2,11,2335.8888888888887,2
2021-04-24,Sat,38,1160.638888888889,2,23,15,36,1079.8064516129032,5
2021-04-25,Sun,24,2755.7727272727275,2,7,17,14,1442.142857142857,0
2021-04-26,Mon,17,1351.125,1,4,13,8,1445.2857142857142,1
2021-04-27,Tue,17,378.2352941176471,0,2,15,4,551.5,2
2021-04-28,Wed,0,0,0,0,0,1,1304.0,0
2021-04-29,Thu,18,1452.5,0,13,5,19,1025.842105263158,0
2021-04-30,Fri,22,7047.85,2,11,11,26,3055.7391304347825,3
2021-05-01,Sat,33,2427.1875,1,16,17,25,1979.15,5
2021-05-02,Sun,43,4957.476190476191,1,10,33,28,2183.64,3
2021-05-03,Mon,0,0,0,0,0,0,0,0
2021-05-04,Tue,0,0,0,0,0,1,0,1
2021-05-05,Wed,12,1278.3333333333333,0,6,6,6,606.5,0
2021-05-06,Thu,36,3521.027777777778,0,17,19,21,1896.5238095238096,0
2021-05-07,Fri,37,6973.411764705882,3,16,21,42,2272.527777777778,6
2021-05-08,Sat,0,0,0,0,0,0,0,0
2021-05-09,Sun,0,0,0,0,0,0,0,0
2021-05-10,Mon,0,0,0,0,0,0,0,0
2021-05-11,Tue,14,622.1818181818181,3,3,11,3,519.0,0
2021-05-12,Wed,46,979.6341463414634,5,7,39,9,487.25,1
2021-05-13,Thu,3,1632.0,1,0,3,4,601.0,0
2021-05-14,Fri,30,648.8571428571429,2,5,25,9,645.4285714285714,2
2021-05-15,Sat,0,0,0,0,0,0,0,0
2021-05-16,Sun,28,659.1304347826087,5,1,27,2,605.5,0
2021-05-17,Mon,6,951.0,0,0,6,0,0,0
2021-05-18,Tue,8,1613.125,0,1,7,1,0,1
2021-05-19,Wed,33,3290.375,1,30,3,39,1194.972972972973,2
2021-05-20,Thu,0,0,0,0,0,0,0,0
2021-05-21,Fri,0,0,0,0,0,0,0,0
2021-05-22,Sat,10,1040.8,0,7,3,10,495.5,0
2021-05-23,Sun,16,1023.1875,0,16,0,16,508.5625,0
2021-05-24,Mon,2,1367.0,0,2,0,4,488.5,2
2021-05-25,Tue,14,1304.857142857143,0,3,11,3,465.3333333333333,0
2021-05-26,Wed,42,794.9756097560976,1,12,30,17,784.2,2
2021-05-27,Thu,58,3177.6111111111113,4,24,34,38,1682.4,3
2021-05-28,Fri,47,1228.8181818181818,3,14,33,21,1304.9473684210527,2
2021-05-29,Sat,48,3703.266666666667,3,17,31,29,2149.1111111111113,2
2021-05-30,Sun,43,1985.0,0,12,31,19,1544.9375,3
2021-05-31,Mon,40,3220.5142857142855,5,16,24,30,971.5,2
2021-06-01,Tue,34,4109.545454545455,1,14,20,25,2293.36,0
2021-06-02,Wed,40,953.0,0,11,29,13,645.5454545454545,2
2021-06-03,Thu,88,870.3218390804598,1,7,81,18,2351.2,3
2021-06-04,Fri,22,580.3809523809524,1,6,16,12,710.5555555555555,3
2021-06-05,Sat,46,9682.720930232557,3,25,21,50,2578.0416666666665,2
2021-06-06,Sun,37,429.94594594594594,0,4,33,4,498.5,0
2021-06-07,Mon,17,2209.625,1,3,14,8,2917.625,0
2021-06-08,Tue,14,1066.3846153846155,1,0,14,5,2799.3333333333335,2
2021-06-09,Wed,45,2321.9555555555557,0,10,35,15,1052.7857142857142,1
2021-06-10,Thu,46,635.6666666666666,1,4,42,5,567.75,1
2021-06-11,Fri,14,708.25,2,0,14,1,0,1
2021-06-12,Sat,43,5165.536585365854,2,18,25,29,1295.6896551724137,0
2021-06-13,Sun,27,3960.88,2,4,23,11,5240.454545454545,0
2021-06-14,Mon,16,1757.625,0,8,8,11,601.375,3
2021-06-15,Tue,28,2100.0,1,14,14,21,1102.0,3
2021-06-16,Wed,40,3031.3684210526317,2,11,29,26,1025.4782608695652,3
2021-06-17,Thu,0,0,0,0,0,0,0,0
2021-06-18,Fri,0,0,0,0,0,0,0,0
2021-06-19,Sat,35,904.074074074074,8,1,34,6,728.3333333333334,0
2021-06-20,Sun,0,0,0,0,0,0,0,0
2021-06-21,Mon,0,0,0,0,0,1,0,1
2021-06-22,Tue,5,2247.0,3,0,5,2,0,2
2021-06-23,Wed,18,3356.6666666666665,12,0,18,9,12758.333333333334,6
2021-06-24,Thu,12,779.625,4,1,11,3,779.6666666666666,0
2021-06-25,Fri,19,432.5625,3,2,17,13,602.1538461538462,0
2021-06-26,Sat,32,491.65625,0,4,28,6,636.75,2
2021-06-27,Sun,0,0,0,0,0,0,0,0
2021-06-28,Mon,0,0,0,0,0,0,0,0
2021-06-29,Tue,23,345.60869565217394,0,0,23,0,0,0
2021-06-30,Wed,25,495.95652173913044,2,0,25,3,1015.0,0
2021-07-01,Thu,33,945.2903225806451,2,9,24,19,1360.0555555555557,1
2021-07-02,Fri,12,1940.909090909091,1,1,11,5,8923.0,4
2021-07-03,Sat,2,4280.5,0,0,2,3,942.0,1
2021-07-04,Sun,0,0,0,0,0,0,0,0
2021-07-05,Mon,40,3321.675,0,20,20,29,1491.1379310344828,0
2021-07-06,Tue,0,0,0,0,0,0,0,0
2021-07-07,Wed,18,963.3888888888889,0,3,15,5,759.0,0
2021-07-08,Thu,51,1051.4117647058824,0,9,42,17,2099.769230769231,4
2021-07-09,Fri,22,1521.05,2,7,15,19,1211.5555555555557,1
2021-07-10,Sat,19,1486.764705882353,2,5,14,13,1267.5384615384614,0
2021-07-11,Sun,16,981.7142857142857,2,5,11,15,1537.8461538461538,2
2021-07-12,Mon,7,1279.5714285714287,0,7,0,8,618.0,0
2021-07-13,Tue,8,4161.857142857143,1,2,6,12,1788.5,2
2021-07-14,Wed,30,4312.827586206897,1,19,11,38,1483.7575757575758,5
2021-07-15,Thu,26,1131.1538461538462,0,23,3,25,522.24,0
2021-07-16,Fri,39,6643.810810810811,2,35,4,60,1882.0535714285713,4
2021-07-17,Sat,62,13051.654545454545,7,39,23,58,3033.8275862068967,0
2021-07-18,Sun,62,12984.166666666666,8,40,22,58,2673.0,0
2021-07-19,Mon,62,16772.053571428572,6,37,25,63,3395.590163934426,2
2021-07-20,Tue,58,15112.822222222223,13,21,37,39,3959.2972972972975,2
2021-07-21,Wed,78,8305.833333333334,18,26,52,65,2406.3389830508477,6
2021-07-22,Thu,83,11714.154929577464,12,17,66,41,3761.837837837838,4
2021-07-23,Fri,1,0,1,0,1,8,1664.2,3
2021-07-24,Sat,13,916.3846153846154,0,13,0,14,540.9285714285714,0
2021-07-25,Sun,2,3008.0,0,1,1,3,2194.5,1
2021-07-26,Mon,26,3312.64,1,10,16,17,2620.4117647058824,0
2021-07-27,Tue,0,0,0,0,0,0,0,0
2021-07-28,Wed,26,700.4,1,0,26,0,0,0
2021-07-29,Thu,43,1778.475,3,8,35,14,532.1666666666666,2
2021-07-30,Fri,0,0,0,0,0,0,0,0
2021-07-31,Sat,36,447.74285714285713,1,1,35,8,2104.4,3
2021-08-01,Sun,10,2243.4444444444443,1,1,9,5,3370.5,1
2021-08-02,Mon,30,4430.5,0,14,16,17,1012.9411764705883,0
2021-08-03,Tue,25,1781.2,0,10,15,17,942.2,2
2021-08-04,Wed,89,4551.977011494253,2,32,57,62,2964.653846153846,10
2021-08-05,Thu,0,0,0,0,0,5,2649.0,2
2021-08-06,Fri,0,0,0,0,0,2,1117.5,0
2021-08-07,Sat,35,6586.030303030303,2,15,20,22,1541.4761904761904,1
2021-08-08,Sun,0,0,0,0,0,2,2080.0,1
2021-08-09,Mon,48,9739.279069767443,5,22,26,29,2525.5,1
2021-08-10,Tue,59,8249.654545454545,4,31,28,51,1941.44,1
2021-08-11,Wed,20,3527.0526315789475,1,5,15,14,3213.818181818182,3
2021-08-12,Thu,67,3796.0338983050847,8,36,31,57,1122.5294117647059,6
2021-08-13,Fri,5,1125.0,0,4,1,4,659.0,0
2021-08-14,Sat,13,2533.4615384615386,0,11,2,13,560.0769230769231,0
2021-08-15,Sun,50,7115.204545454545,6,35,15,46,1376.3777777777777,1
2021-08-16,Mon,20,775.0526315789474,1,1,19,3,0,3
2021-08-17,Tue,22,432.22727272727275,0,2,20,2,434.0,0
2021-08-18,Wed,81,562.2,1,10,71,12,1542.090909090909,1
2021-08-19,Thu,43,832.2325581395348,0,9,34,11,606.0,0
2021-08-20,Fri,44,1103.9545454545455,0,12,32,16,714.3333333333334,1
2021-08-21,Sat,1,287.0,0,0,1,0,0,0
2021-08-22,Sun,22,473.09090909090907,0,2,20,3,567.6666666666666,0
2021-08-23,Mon,34,3063.90625,2,18,16,22,654.8571428571429,1
2021-08-24,Tue,57,677.6140350877193,0,11,46,18,1432.9375,2
2021-08-25,Wed,48,598.9375,0,0,48,2,0,2
2021-08-26,Thu,5,961.0,0,3,2,5,481.4,0
2021-08-27,Fri,53,684.3584905660377,0,11,42,18,1325.5,6
2021-08-28,Sat,18,9776.0,2,8,10,24,2411.3478260869565,1
2021-08-29,Sun,54,674.9444444444445,0,10,44,20,3645.6470588235293,3
2021-08-30,Mon,19,603.6315789473684,0,0,19,5,6646.75,1
2021-08-31,Tue,25,955.32,0,3,22,3,496.3333333333333,0
2021-09-01,Wed,59,606.0338983050848,0,10,49,13,538.5,1
2021-09-02,Thu,60,913.2033898305085,1,20,40,27,458.52,2
2021-09-03,Fri,55,603.3090909090909,0,9,46,10,511.6666666666667,1
2021-09-04,Sat,52,941.6923076923077,0,8,44,13,2009.8461538461538,0
2021-09-05,Sun,35,1838.4,0,11,24,11,618.2727272727273,0
2021-09-06,Mon,31,3425.6774193548385,0,10,21,26,2690.0588235294117,9
2021-09-07,Tue,32,2250.125,0,12,20,22,2263.5882352941176,5
2021-09-08,Wed,27,917.1111111111111,0,5,22,13,3299.923076923077,0
2021-09-09,Thu,4,1540.5,0,4,0,4,661.25,0
2021-09-10,Fri,0,0,0,0,0,0,0,0
2021-09-11,Sat,52,1408.923076923077,0,7,45,14,5387.727272727273,3
2021-09-12,Sun,41,1260.425,1,11,30,19,3867.5555555555557,1
2021-09-13,Mon,25,1282.56,0,20,5,20,602.85,0
2021-09-14,Tue,0,0,0,0,0,0,0,0
2021-09-15,Wed,67,879.5909090909091,1,24,43,27,602.3333333333334,0
2021-09-16,Thu,46,3260.6046511627906,3,27,19,48,1586.0681818181818,4
2021-09-17,Fri,47,1913.25,3,22,25,30,828.3,0
2021-09-18,Sat,79,1705.113924050633,0,29,50,40,2213.0,2
2021-09-19,Sun,16,900.375,0,3,13,7,674.5714285714286,0
2021-09-20,Mon,30,2632.866666666667,0,9,21,17,2201.8125,1
2021-09-21,Tue,27,3155.36,2,12,15,20,1617.5,2
2021-09-22,Wed,50,2348.36,0,11,39,27,885.0,6
2021-09-23,Thu,18,783.0,3,4,14,15,1004.4666666666667,0
2021-09-24,Fri,35,740.8285714285714,0,5,30,10,2406.375,2
2021-09-25,Sat,39,1185.179487179487,0,6,33,9,3542.1111111111113,0
2021-09-26,Sun,49,1859.25,1,13,36,16,1195.6875,0
2021-09-27,Mon,0,0,0,0,0,0,0,0
2021-09-28,Tue,0,0,0,0,0,0,0,0
2021-09-29,Wed,22,1696.2727272727273,0,3,19,5,2429.0,0
2021-09-30,Thu,0,0,0,0,0,0,0,0
2021-10-01,Fri,8,1888.125,0,3,5,3,609.3333333333334,0
2021-10-02,Sat,0,0,0,0,0,0,0,0
2021-10-03,Sun,0,0,0,0,0,3,1758.0,0
2021-10-04,Mon,3,1303.0,0,2,1,3,858.6666666666666,0
2021-10-05,Tue,0,0,0,0,0,1,126.0,0
2021-10-06,Wed,46,1273.804347826087,0,13,33,21,645.0952380952381,0
2021-10-07,Thu,18,250.72222222222223,0,0,18,4,0,4
2021-10-08,Fri,0,0,0,0,0,0,0,0
2021-10-09,Sat,47,863.6170212765958,0,14,33,17,624.4375,1
2021-10-10,Sun,36,2067.8888888888887,0,23,13,33,1741.5625,1
2021-10-11,Mon,0,0,0,0,0,4,6051.0,3
2021-10-12,Tue,0,0,0,0,0,2,0,2
2021-10-13,Wed,24,410.7083333333333,0,0,24,3,375.0,0
2021-10-14,Thu,1,923.0,0,1,0,4,900.25,0
2021-10-15,Fri,20,3367.0,0,20,0,31,1612.4137931034484,2
2021-10-16,Sat,48,765.2916666666666,0,17,31,28,2453.5652173913045,5
2021-10-17,Sun,0,0,0,0,0,2,197.5,0
2021-10-18,Mon,0,0,0,0,0,0,0,0
2021-10-19,Tue,0,0,0,0,0,0,0,0
2021-10-20,Wed,0,0,0,0,0,0,0,0
2021-10-21,Thu,0,0,0,0,0,0,0,0
2021-10-22,Fri,0,0,0,0,0,0,0,0
2021-10-23,Sat,19,732.0526315789474,0,9,10,12,3026.4166666666665,0
2021-10-24,Sun,3,389.3333333333333,0,1,2,1,520.0,0
2021-10-25,Mon,0,0,0,0,0,2,928.5,0
2021-10-26,Tue,0,0,0,0,0,0,0,0
2021-10-27,Wed,0,0,0,0,0,0,0,0
2021-10-28,Thu,0,0,0,0,0,2,0,2
2021-10-29,Fri,0,0,0,0,0,0,0,0
2021-10-30,Sat,22,846.3181818181819,0,5,17,6,714.1666666666666,0
2021-10-31,Sun,0,0,0,0,0,0,0,0
2021-11-01,Mon,0,0,0,0,0,0,0,0
2021-11-02,Tue,0,0,0,0,0,4,5925.333333333333,1
2021-11-03,Wed,0,0,0,0,0,0,0,0
2021-11-04,Thu,1,1657.0,0,0,1,1,1335.0,0
2021-11-05,Fri,0,0,0,0,0,1,0,1
2021-11-06,Sat,0,0,0,0,0,1,1358.0,0
2021-11-07,Sun,11,2627.5454545454545,0,0,11,1,0,1
2021-11-08,Mon,4,1716.0,0,0,4,2,4845.0,1
2021-11-09,Tue,5,1389.0,0,0,5,0,0,0
2021-11-10,Wed,1,296.0,0,0,1,0,0,0
2021-11-11,Thu,1,1161.0,0,0,1,0,0,0
2021-11-12,Fri,0,0,0,0,0,0,0,0
2021-11-13,Sat,38,709.5526315789474,0,7,31,7,549.8571428571429,0
2021-11-14,Sun,13,898.0,0,12,1,13,512.6153846153846,0
2021-11-15,Mon,1,1737.0,0,0,1,0,0,0
2021-11-16,Tue,0,0,0,0,0,0,0,0
2021-11-17,Wed,53,732.0188679245283,0,17,36,26,798.4782608695652,3
2021-11-18,Thu,1,1173.0,0,0,1,3,8330.0,2
2021-11-19,Fri,2,3240.0,0,0,2,1,11381.0,0
2021-11-20,Sat,47,533.4042553191489,0,4,43,7,455.2,2
2021-11-21,Sun,11,1368.6363636363637,0,8,3,11,651.8181818181819,0
2021-11-22,Mon,5,1190.2,0,0,5,0,0,0
2021-11-23,Tue,10,740.8,0,2,8,3,3684.3333333333335,0
2021-11-24,Wed,0,0,0,0,0,0,0,0
2021-11-25,Thu,6,1444.0,0,0,6,2,648.0,0
2021-11-26,Fri,0,0,0,0,0,1,0,1
2021-11-27,Sat,0,0,0,0,0,0,0,0
2021-11-28,Sun,15,1106.9333333333334,0,10,5,10,586.3,0
2021-11-29,Mon,1,1191.0,0,0,1,0,0,0
2021-11-30,Tue,5,918.0,0,0,5,0,0,0
2021-12-01,Wed,0,0,0,0,0,0,0,0
2021-12-02,Thu,9,791.8888888888889,0,0,9,2,1559.5,0
2021-12-03,Fri,0,0,0,0,0,0,0,0
2021-12-04,Sat,17,327.6470588235294,0,0,17,6,1109.2,1
2021-12-05,Sun,3,387.0,0,3,0,5,450.0,2
2021-12-06,Mon,0,0,0,0,0,0,0,0
2021-12-07,Tue,0,0,0,0,0,0,0,0
2021-12-08,Wed,0,0,0,0,0,0,0,0
2021-12-09,Thu,16,1220.5,0,11,5,12,575.75,0
2021-12-10,Fri,1,634.0,0,0,1,1,3024.0,0
2021-12-11,Sat,11,1053.6363636363637,0,7,4,8,581.125,0
2021-12-12,Sun,0,0,0,0,0,2,138.5,0
2021-12-13,Mon,0,0,0,0,0,0,0,0
2021-12-14,Tue,0,0,0,0,0,0,0,0
2021-12-15,Wed,35,638.0285714285715,0,9,26,11,524.3636363636364,0
2021-12-16,Thu,2,2402.5,0,0,2,5,594.6666666666666,2
2021-12-17,Fri,0,0,0,0,0,0,0,0
2021-12-18,Sat,0,0,0,0,0,0,0,0
2021-12-19,Sun,0,0,0,0,0,0,0,0
2021-12-20,Mon,0,0,0,0,0,0,0,0
2021-12-21,Tue,5,1857.6,0,0,5,0,0,0
2021-12-22,Wed,24,927.2083333333334,0,7,17,9,631.625,1
2021-12-23,Thu,0,0,0,0,0,0,0,0
2021-12-24,Fri,0,0,0,0,0,0,0,0
2021-12-25,Sat,0,0,0,0,0,0,0,0
2021-12-26,Sun,0,0,0,0,0,0,0,0
2021-12-27,Mon,0,0,0,0,0,0,0,0
2021-12-28,Tue,0,0,0,0,0,0,0,0
2021-12-29,Wed,0,0,0,0,0,0,0,0
2021-12-30,Thu,0,0,0,0,0,0,0,0
2021-12-31,Fri,0,0,0,0,0,0,0,0
2022-01-01,Sat,0,0,0,0,0,0,0,0
2022-01-02,Sun,5,886.8,0,4,1,6,512.6666666666666,0
2022-01-03,Mon,14,879.3571428571429,0,14,0,14,558.5,0
2022-01-04,Tue,2,1885.0,0,0,2,0,0,0
2022-01-05,Wed,25,1206.96,0,24,1,27,654.5769230769231,1
2022-01-06,Thu,0,0,0,0,0,0,0,0
2022-01-07,Fri,6,638.8333333333334,0,0,6,2,0,2
2022-01-08,Sat,0,0,0,0,0,0,0,0
2022-01-09,Sun,21,1157.6666666666667,0,17,4,18,574.7777777777778,0
2022-01-10,Mon,0,0,0,0,0,0,0,0
2022-01-11,Tue,0,0,0,0,0,0,0,0
2022-01-12,Wed,21,1597.5238095238096,0,18,3,23,783.9047619047619,2
2022-01-13,Thu,4,5104.0,0,0,4,4,806.3333333333334,1
2022-01-14,Fri,3,1159.0,0,0,3,2,2608.5,0
2022-01-15,Sat,1,1721.0,0,0,1,3,790.3333333333334,0
2022-01-16,Sun,20,938.1,0,18,2,22,608.9090909090909,0
2022-01-17,Mon,0,0,0,0,0,2,1955.5,0
2022-01-18,Tue,1,1008.0,0,0,1,0,0,0
2022-01-19,Wed,13,914.9230769230769,0,0,13,3,1820.0,0
2022-01-20,Thu,6,1399.3333333333333,0,0,6,0,0,0
2022-01-21,Fri,2,2835.5,0,0,2,2,0,2
2022-01-22,Sat,45,509.15555555555557,0,0,45,6,943.0,4
2022-01-23,Sun,15,291.8,0,0,15,0,0,0
2022-01-24,Mon,1,1678.0,0,0,1,0,0,0
2022-01-25,Tue,0,0,0,0,0,0,0,0
2022-01-26,Wed,28,619.4285714285714,0,0,28,1,1293.0,0
2022-01-27,Thu,6,333.3333333333333,0,0,6,0,0,0
2022-01-28,Fri,2,2903.5,0,0,2,0,0,0
2022-01-29,Sat,0,0,0,0,0,0,0,0
2022-01-30,Sun,40,861.65,0,6,34,9,1057.6666666666667,0
2022-01-31,Mon,0,0,0,0,0,0,0,0
2022-02-01,Tue,0,0,0,0,0,0,0,0
2022-02-02,Wed,48,649.6875,0,6,42,11,1570.888888888889,2
2022-02-03,Thu,2,2804.5,0,0,2,2,1816.5,0
2022-02-04,Fri,6,317.1666666666667,0,0,6,0,0,0
2022-02-05,Sat,13,517.5384615384615,0,1,12,1,719.0,0
2022-02-06,Sun,0,0,0,0,0,0,0,0
2022-02-07,Mon,0,0,0,0,0,0,0,0
2022-02-08,Tue,5,888.6,0,0,5,2,0,2
2022-02-09,Wed,1,5642.0,0,0,1,0,0,0
2022-02-10,Thu,39,875.5128205128206,0,8,31,8,477.125,0
2022-02-11,Fri,4,3274.25,0,0,4,4,828.5,2
2022-02-12,Sat,0,0,0,0,0,0,0,0
2022-02-13,Sun,0,0,0,0,0,0,0,0
2022-02-14,Mon,0,0,0,0,0,0,0,0
2022-02-15,Tue,0,0,0,0,0,0,0,0
2022-02-16,Wed,0,0,0,0,0,0,0,0
2022-02-17,Thu,0,0,0,0,0,0,0,0
2022-02-18,Fri,0,0,0,0,0,0,0,0
2022-02-19,Sat,0,0,0,0,0,0,0,0
2022-02-20,Sun,0,0,0,0,0,0,0,0
2022-02-21,Mon,0,0,0,0,0,0,0,0
2022-02-22,Tue,0,0,0,0,0,0,0,0
2022-02-23,Wed,2,0,2,0,2,1,0,1
2022-02-24,Thu,0,0,0,0,0,0,0,0
2022-02-25,Fri,1,0,1,0,1,0,0,0
2022-02-26,Sat,0,0,0,0,0,0,0,0
2022-02-27,Sun,0,0,0,0,0,0,0,0
2022-02-28,Mon,0,0,0,0,0,0,0,0
2022-03-01,Tue,0,0,0,0,0,0,0,0
2022-03-02,Wed,0,0,0,0,0,0,0,0
2022-03-03,Thu,8,471.0,0,0,8,1,3799.0,0
2022-03-04,Fri,0,0,0,0,0,1,1314.0,0
2022-03-05,Sat,0,0,0,0,0,0,0,0
2022-03-06,Sun,17,1388.5294117647059,0,17,0,18,517.3888888888889,0
2022-03-07,Mon,0,0,0,0,0,12,470.875,4
2022-03-08,Tue,0,0,0,0,0,3,3046.6666666666665,0
2022-03-09,Wed,0,0,0,0,0,1,1232.0,0
2022-03-10,Thu,0,0,0,0,0,0,0,0
2022-03-11,Fri,0,0,0,0,0,0,0,0
2022-03-12,Sat,0,0,0,0,0,1,0,1
2022-03-13,Sun,0,0,0,0,0,0,0,0
2022-03-14,Mon,4,11043.75,0,3,1,15,1706.1538461538462,2
2022-03-15,Tue,0,0,0,0,0,4,3185.75,0
2022-03-16,Wed,0,0,0,0,0,0,0,0
2022-03-17,Thu,18,1498.2222222222222,0,16,2,18,1059.4444444444443,0
2022-03-18,Fri,6,1388.5,0,0,6,3,8000.0,2
2022-03-19,Sat,35,597.6571428571428,0,0,35,1,459.0,0
2022-03-20,Sun,47,3184.2127659574467,0,14,33,20,1074.0526315789473,1
2022-03-21,Mon,8,2120.0,1,0,8,4,788.0,2
2022-03-22,Tue,11,889.6363636363636,0,0,11,7,0,7
2022-03-23,Wed,34,4080.823529411765,0,28,6,33,465.83870967741933,2
2022-03-24,Thu,3,1053.6666666666667,0,0,3,0,0,0
2022-03-25,Fri,13,4104.2307692307695,0,9,4,16,637.0,3
2022-03-26,Sat,50,2049.5102040816328,1,1,49,3,11219.666666666666,0
2022-03-27,Sun,1,2403.0,0,0,1,0,0,0
2022-03-28,Mon,5,1002.2,0,0,5,0,0,0
2022-03-29,Tue,0,0,0,0,0,0,0,0
2022-03-30,Wed,0,0,0,0,0,0,0,0
2022-03-31,Thu,0,0,0,0,0,0,0,0
2022-04-01,Fri,0,0,0,0,0,2,1677.0,1
2022-04-02,Sat,17,1504.1176470588234,0,17,0,20,696.3,0
2022-04-03,Sun,19,1360.421052631579,0,16,3,19,799.5263157894736,0
2022-04-04,Mon,0,0,0,0,0,0,0,0
2022-04-05,Tue,0,0,0,0,0,0,0,0
2022-04-06,Wed,0,0,0,0,0,0,0,0
2022-04-07,Thu,0,0,0,0,0,0,0,0
2022-04-08,Fri,30,6490.033333333334,0,22,8,24,487.0416666666667,0
2022-04-09,Sat,35,4456.8,0,24,11,28,629.7307692307693,2
2022-04-10,Sun,39,4129.486486486487,2,18,21,20,890.35,0
2022-04-11,Mon,5,621.4,0,2,3,11,457.44444444444446,2
2022-04-12,Tue,11,939.1818181818181,0,8,3,16,440.125,0
2022-04-13,Wed,33,410.09090909090907,0,3,30,4,691.5,0
2022-04-14,Thu,25,1133.36,0,9,16,12,764.8333333333334,0
2022-04-15,Fri,50,3127.82,0,20,30,28,752.75,0
2022-04-16,Sat,57,1791.578947368421,0,22,35,38,1062.0967741935483,7
2022-04-17,Sun,11,1397.090909090909,0,6,5,10,2002.6,0
2022-04-18,Mon,26,7852.807692307692,0,14,12,21,2460.5238095238096,0
2022-04-19,Tue,9,1492.111111111111,0,3,6,5,652.6666666666666,2
2022-04-20,Wed,63,2105.8870967741937,1,13,50,16,664.4666666666667,1
2022-04-21,Thu,35,1529.0285714285715,0,11,24,12,579.6666666666666,0
2022-04-22,Fri,29,550.4827586206897,0,0,29,0,0,0
2022-04-23,Sat,0,0,0,0,0,1,857.0,0
2022-04-24,Sun,24,4492.083333333333,0,24,0,27,823.24,2
2022-04-25,Mon,21,882.5238095238095,0,10,11,16,887.1428571428571,2
2022-04-26,Tue,34,4014.2727272727275,1,15,19,17,688.0,0
2022-04-27,Wed,46,760.4565217391304,0,6,40,11,1344.5,1
2022-04-28,Thu,38,455.7631578947368,0,7,31,12,903.25,4
2022-04-29,Fri,29,1895.2142857142858,1,24,5,28,770.8148148148148,1
2022-04-30,Sat,36,8360.057142857142,1,26,10,42,1671.25,2
2022-05-01,Sun,0,0,0,0,0,0,0,0
2022-05-02,Mon,39,3445.7631578947367,1,33,6,43,850.5238095238095,1
2022-05-03,Tue,0,0,0,0,0,3,1627.3333333333333,0
2022-05-04,Wed,0,0,0,0,0,0,0,0
2022-05-05,Thu,51,3953.5833333333335,3,33,18,46,1173.6521739130435,0
2022-05-06,Fri,23,3249.5,3,19,4,28,556.9166666666666,4
2022-05-07,Sat,42,6671.275,2,36,6,45,1208.6190476190477,3
2022-05-08,Sun,58,7813.589285714285,2,30,28,39,1705.3783783783783,2
2022-05-09,Mon,2,1593.5,0,2,0,5,867.0,3
2022-05-10,Tue,11,2136.2727272727275,0,2,9,3,899.0,1
2022-05-11,Wed,0,0,0,0,0,0,0,0
2022-05-12,Thu,59,3371.8793103448274,1,12,47,18,570.3571428571429,4
2022-05-13,Fri,0,0,0,0,0,1,3049.0,0
2022-05-14,Sat,56,6260.553571428572,0,22,34,36,2156.516129032258,5
2022-05-15,Sun,9,895.4444444444445,0,5,4,8,1564.375,0
2022-05-16,Mon,0,0,0,0,0,0,0,0
2022-05-17,Tue,20,1498.9,0,10,10,16,1160.3846153846155,3
2022-05-18,Wed,57,1377.0,0,14,43,22,792.9444444444445,4
2022-05-19,Thu,61,3983.4918032786886,0,21,40,25,1213.2608695652175,2
2022-05-20,Fri,1,2466.0,0,0,1,1,0,1
2022-05-21,Sat,45,2073.2,0,11,34,17,2533.0,2
2022-05-22,Sun,33,3094.818181818182,0,14,19,19,1331.0,3
2022-05-23,Mon,8,1306.875,0,2,6,4,729.0,2
2022-05-24,Tue,9,604.5,1,1,8,5,621.6666666666666,2
2022-05-25,Wed,0,0,0,0,0,2,1044.5,0
2022-05-26,Thu,0,0,0,0,0,0,0,0
2022-05-27,Fri,20,4852.65,0,16,4,20,1310.6,0
2022-05-28,Sat,58,5638.482758620689,0,26,32,42,1868.8333333333333,0
2022-05-29,Sun,20,2635.4,0,15,5,19,1067.4705882352941,2
2022-05-30,Mon,39,812.421052631579,1,6,33,9,757.875,1
2022-05-31,Tue,1,2708.0,0,0,1,0,0,0
2022-06-01,Wed,44,1474.7954545454545,0,7,37,12,667.3333333333334,3
2022-06-02,Thu,62,6094.6949152542375,3,26,36,44,1676.046511627907,1
2022-06-03,Fri,20,1572.7894736842106,1,6,14,11,1803.3333333333333,2
2022-06-04,Sat,0,0,0,0,0,0,0,0
2022-06-05,Sun,0,0,0,0,0,0,0,0
2022-06-06,Mon,2,3473.0,0,0,2,2,1179.0,1
2022-06-07,Tue,18,2546.5,0,13,5,22,1564.85,2
2022-06-08,Wed,20,1049.5263157894738,1,8,12,10,624.0,0
2022-06-09,Thu,14,2650.0,0,7,7,10,909.3,0
2022-06-10,Fri,14,7445.357142857143,0,8,6,13,3472.9,3
2022-06-11,Sat,18,715.0555555555555,0,0,18,0,0,0
2022-06-12,Sun,44,7720.511627906977,1,36,8,44,1028.840909090909,0
2022-06-13,Mon,31,1190.0689655172414,2,9,22,18,1904.2777777777778,0
2022-06-14,Tue,37,6691.108108108108,0,14,23,25,1903.6363636363637,3
2022-06-15,Wed,48,1635.5531914893618,1,11,37,23,3082.590909090909,1
2022-06-16,Thu,32,1737.6774193548388,1,7,25,11,980.6666666666666,2
2022-06-17,Fri,2,1928.5,0,1,1,3,512.0,1
2022-06-18,Sat,0,0,0,0,0,1,1096.0,0
2022-06-19,Sun,15,1414.2,0,15,0,21,4620.0,1
2022-06-20,Mon,17,3320.9411764705883,0,15,2,25,1476.08,0
2022-06-21,Tue,29,4905.888888888889,2,11,18,20,1028.5,2
2022-06-22,Wed,25,1609.0,19,9,16,16,511.3636363636364,5
2022-06-23,Thu,15,1433.9285714285713,1,3,12,13,2678.6153846153848,0
2022-06-24,Fri,8,796.0,0,3,5,10,539.1111111111111,1
2022-06-25,Sat,1,11674.0,0,0,1,0,0,0
2022-06-26,Sun,0,0,0,0,0,1,0,1
2022-06-27,Mon,17,1773.235294117647,0,7,10,7,716.1428571428571,0
2022-06-28,Tue,0,0,0,0,0,0,0,0
2022-06-29,Wed,13,2635.076923076923,0,13,0,15,656.4,0
2022-06-30,Thu,22,1014.8181818181819,0,2,20,6,1223.3333333333333,0
2022-07-01,Fri,24,2560.9565217391305,1,9,15,11,2508.4545454545455,0
2022-07-02,Sat,1,639.0,0,0,1,1,4827.0,0
2022-07-03,Sun,18,2355.1111111111113,0,8,10,15,2255.6923076923076,2
2022-07-04,Mon,39,1415.2820512820513,0,5,34,7,1067.0,0
2022-07-05,Tue,33,2886.939393939394,0,20,13,29,882.7241379310345,0
2022-07-06,Wed,15,3780.6,0,12,3,15,636.3846153846154,2
2022-07-07,Thu,38,5104.3421052631575,0,33,5,38,732.0833333333334,2
2022-07-08,Fri,27,5617.92,2,11,16,14,1013.5,0
2022-07-09,Sat,38,5122.189189189189,1,28,10,38,1307.7631578947369,0
2022-07-10,Sun,27,3676.777777777778,0,7,20,11,1940.7272727272727,0
2022-07-11,Mon,34,5051.727272727273,1,9,25,9,669.1111111111111,0
2022-07-12,Tue,20,865.55,0,5,15,9,1118.4444444444443,0
2022-07-13,Wed,25,3871.0,0,21,4,24,774.8260869565217,1
2022-07-14,Thu,34,10790.424242424242,1,30,4,50,1988.6444444444444,5
2022-07-15,Fri,36,4410.411764705882,2,16,20,36,1556.6060606060605,3
2022-07-16,Sat,38,0,38,2,36,10,456.0,9
2022-07-17,Sun,59,13820.627450980392,8,26,33,56,2758.7045454545455,12
2022-07-18,Mon,0,0,0,0,0,7,0,7
2022-07-19,Tue,0,0,0,0,0,1,9473.0,0
2022-07-20,Wed,5,1330.2,0,0,5,7,2277.0,3
2022-07-21,Thu,25,824.08,0,7,18,20,3837.0,3
2022-07-22,Fri,1,7184.0,0,1,0,8,958.8333333333334,2
2022-07-23,Sat,39,6332.846153846154,0,30,9,54,2039.408163265306,5
2022-07-24,Sun,0,0,0,0,0,1,0,1
2022-07-25,Mon,25,1135.36,0,10,15,12,837.1,2
2022-07-26,Tue,24,2152.75,0,15,9,18,713.8666666666667,3
2022-07-27,Wed,56,2596.163636363636,1,13,43,19,817.8235294117648,2
2022-07-28,Thu,26,1530.6842105263158,7,8,18,9,696.2857142857143,2
2022-07-29,Fri,41,6454.2,1,24,17,34,1279.0967741935483,3
2022-07-30,Sat,24,1136.4166666666667,0,11,13,12,603.9166666666666,0
2022-07-31,Sun,1,2132.0,0,0,1,0,0,0
2022-08-01,Mon,32,5364.125,0,18,14,26,1583.1363636363637,4
2022-08-02,Tue,0,0,0,0,0,0,0,0
2022-08-03,Wed,13,3738.153846153846,0,9,4,10,1520.3,0
2022-08-04,Thu,36,5586.138888888889,0,24,12,31,807.3448275862069,2
2022-08-05,Fri,32,13329.967741935483,1,18,14,31,3453.5,1
2022-08-06,Sat,43,3544.279069767442,0,16,27,36,2008.3823529411766,2
2022-08-07,Sun,41,6823.609756097561,0,19,22,32,2143.4193548387098,1
2022-08-08,Mon,21,13837.0,0,17,4,29,3764.9615384615386,3
2022-08-09,Tue,37,10611.054054054053,0,28,9,46,2297.1111111111113,1
2022-08-10,Wed,53,5014.603773584906,0,16,37,33,2751.5,3
2022-08-11,Thu,44,6352.75,0,23,21,38,1818.7714285714285,3
2022-08-12,Fri,32,8283.387096774193,1,15,17,281,6333.8125,217
2022-08-13,Sat,13,3793.3636363636365,2,0,13,2,7995.0,1
2022-08-14,Sun,49,11991.255319148937,2,16,33,196,10100.09677419355,134
2022-08-15,Mon,8,1840.625,0,5,3,9,1153.5714285714287,2
2022-08-16,Tue,0,0,0,0,0,1,1747.0,0
2022-08-17,Wed,1,720.0,0,0,1,0,0,0
2022-08-18,Thu,41,9039.52,16,27,14,87,5071.75,27
2022-08-19,Fri,39,1496.0,38,22,17,75,489.6896551724138,46
2022-08-20,Sat,60,5784.103448275862,2,21,39,118,4674.827272727272,8
2022-08-21,Sun,32,15026.0,4,13,19,33,3263.2258064516127,2
2022-08-22,Mon,21,6972.476190476191,0,13,8,29,2172.5263157894738,10
2022-08-23,Tue,33,0,33,10,23,55,645.6923076923077,42
2022-08-24,Wed,12,986.6363636363636,1,11,1,15,668.5,3
2022-08-25,Thu,5,2486.4,0,0,5,8,4186.142857142857,1
2022-08-26,Fri,39,12877.103448275862,10,21,18,79,6279.372881355932,20
2022-08-27,Sat,29,4157.275862068966,0,12,17,24,2878.818181818182,2
2022-08-28,Sun,29,4347.310344827586,0,10,19,26,3617.04,1
2022-08-29,Mon,8,3853.0,0,1,7,2,456.0,1
2022-08-30,Tue,16,1804.1875,0,13,3,17,779.5625,1
2022-08-31,Wed,23,5404.04347826087,0,20,3,24,1076.0,0
2022-09-01,Thu,38,3244.7105263157896,0,14,24,19,1996.888888888889,1
2022-09-02,Fri,28,1049.5,0,13,15,13,839.6153846153846,0
2022-09-03,Sat,28,1813.0357142857142,0,19,9,24,705.25,0
2022-09-04,Sun,1,416.0,0,1,0,1,379.0,0
2022-09-05,Mon,12,1420.3333333333333,0,7,5,7,783.4285714285714,0
2022-09-06,Tue,0,0,0,0,0,0,0,0
2022-09-07,Wed,0,0,0,0,0,0,0,0
2022-09-08,Thu,6,1065.1666666666667,0,4,2,5,697.25,1
2022-09-09,Fri,18,988.7777777777778,0,6,12,6,586.6666666666666,0
2022-09-10,Sat,21,719.7619047619048,0,3,18,4,2245.0,0
2022-09-11,Sun,30,876.6666666666666,0,13,17,14,1532.857142857143,0
2022-09-12,Mon,10,2566.1,0,4,6,6,1507.6,1
2022-09-13,Tue,18,963.7222222222222,0,5,13,17,1205.2222222222222,8
2022-09-14,Wed,45,2146.1555555555556,0,17,28,24,1103.4166666666667,0
2022-09-15,Thu,20,1939.35,0,19,1,30,577.2333333333333,0
2022-09-16,Fri,24,9044.416666666666,0,22,2,26,842.1923076923077,0
2022-09-17,Sat,26,4563.2692307692305,0,21,5,37,1124.2727272727273,4
2022-09-18,Sun,8,1316.875,0,6,2,7,607.5,1
2022-09-19,Mon,0,0,0,0,0,3,0,3
2022-09-20,Tue,20,2953.1111111111113,2,6,14,12,920.5833333333334,0
2022-09-21,Wed,45,1933.7954545454545,1,15,30,19,796.0,0
2022-09-22,Thu,12,2826.1666666666665,0,8,4,8,602.875,0
2022-09-23,Fri,9,5749.222222222223,0,7,2,11,812.1818181818181,0
2022-09-24,Sat,25,2115.9583333333335,1,19,6,25,1496.0,0
2022-09-25,Sun,25,4713.72,0,19,6,19,524.0,0
2022-09-26,Mon,0,0,0,0,0,0,0,0
2022-09-27,Tue,1,1132.0,0,0,1,0,0,0
2022-09-28,Wed,55,1755.490909090909,0,12,43,19,801.6666666666666,4
2022-09-29,Thu,26,909.1923076923077,0,6,20,6,640.6666666666666,0
2022-09-30,Fri,0,0,0,0,0,0,0,0
2022-10-01,Sat,31,1114.3666666666666,1,0,31,1,5239.0,0
2022-10-02,Sun,33,1577.909090909091,0,0,33,1,4771.0,0
2022-10-03,Mon,20,1734.85,0,0,20,0,0,0
2022-10-04,Tue,0,0,0,0,0,0,0,0
2022-10-05,Wed,5,381.2,0,0,5,0,0,0
2022-10-06,Thu,28,789.3703703703703,1,7,21,7,746.8571428571429,0
2022-10-07,Fri,0,0,0,0,0,0,0,0
2022-10-08,Sat,37,3929.7027027027025,0,22,15,35,584.65625,3
2022-10-09,Sun,0,0,0,0,0,0,0,0
2022-10-10,Mon,14,2765.5714285714284,0,7,7,11,1272.2727272727273,0
2022-10-11,Tue,23,2899.5652173913045,0,8,15,13,1631.1,3
2022-10-12,Wed,36,567.0277777777778,0,5,31,8,542.2857142857143,1
2022-10-13,Thu,22,616.6363636363636,0,4,18,6,661.4,1
2022-10-14,Fri,10,1762.2,0,3,7,3,517.6666666666666,0
2022-10-15,Sat,6,1690.4,1,5,1,5,619.0,0
2022-10-16,Sun,29,3375.2413793103447,0,27,2,34,1151.735294117647,0
2022-10-17,Mon,0,0,0,0,0,0,0,0
2022-10-18,Tue,21,1352.2857142857142,0,7,14,12,1396.090909090909,1
2022-10-19,Wed,21,565.2380952380952,0,3,18,4,535.75,0
2022-10-20,Thu,0,0,0,0,0,0,0,0
2022-10-21,Fri,0,0,0,0,0,0,0,0
2022-10-22,Sat,30,1664.4666666666667,0,17,13,24,693.304347826087,1
2022-10-23,Sun,0,0,0,0,0,3,2960.3333333333335,0
2022-10-24,Mon,4,1472.5,0,2,2,2,900.0,0
2022-10-25,Tue,20,1555.2105263157894,1,8,12,12,1735.0,0
2022-10-26,Wed,0,0,0,0,0,0,0,0
2022-10-27,Thu,0,0,0,0,0,0,0,0
2022-10-28,Fri,2,2519.0,0,0,2,0,0,0
2022-10-29,Sat,12,268.6666666666667,0,0,12,2,1720.0,1
2022-10-30,Sun,2,0,2,0,2,0,0,0
2022-10-31,Mon,0,0,0,0,0,0,0,0
2022-11-01,Tue,0,0,0,0,0,0,0,0
2022-11-02,Wed,0,0,0,0,0,0,0,0
2022-11-03,Thu,8,1361.125,0,0,8,1,0,1
2022-11-04,Fri,21,916.3333333333334,0,7,14,13,1782.3636363636363,2
2022-11-05,Sat,0,0,0,0,0,0,0,0
2022-11-06,Sun,1,2990.0,0,0,1,0,0,0
2022-11-07,Mon,0,0,0,0,0,0,0,0
2022-11-08,Tue,0,0,0,0,0,0,0,0
2022-11-09,Wed,38,1091.657894736842,0,8,30,12,1144.8333333333333,0
2022-11-10,Thu,0,0,0,0,0,0,0,0
2022-11-11,Fri,0,0,0,0,0,0,0,0
2022-11-12,Sat,28,870.3214285714286,0,7,21,8,575.75,0
2022-11-13,Sun,0,0,0,0,0,0,0,0
2022-11-14,Mon,0,0,0,0,0,0,0,0
2022-11-15,Tue,0,0,0,0,0,0,0,0
2022-11-16,Wed,0,0,0,0,0,0,0,0
2022-11-17,Thu,0,0,0,0,0,0,0,0
2022-11-18,Fri,6,1052.5,0,0,6,0,0,0
2022-11-19,Sat,39,1017.8461538461538,0,10,29,14,700.9285714285714,0
2022-11-20,Sun,15,1087.1333333333334,0,15,0,16,623.5,0
2022-11-21,Mon,0,0,0,0,0,0,0,0
2022-11-22,Tue,0,0,0,0,0,0,0,0
2022-11-23,Wed,5,804.6,0,5,0,5,539.6,0
2022-11-24,Thu,0,0,0,0,0,0,0,0
2022-11-25,Fri,8,1574.25,0,0,8,4,1279.25,0
2022-11-26,Sat,4,960.0,0,4,0,4,465.25,0
2022-11-27,Sun,14,1810.5,0,4,10,15,552.3333333333334,0
2022-11-28,Mon,4,1544.75,0,0,4,0,0,0
2022-11-29,Tue,0,0,0,0,0,0,0,0
2022-11-30,Wed,20,601.15,0,0,20,0,0,0
2022-12-01,Thu,0,0,0,0,0,0,0,0
2022-12-02,Fri,0,0,0,0,0,0,0,0
2022-12-03,Sat,4,1641.5,0,2,2,2,842.0,0
2022-12-04,Sun,0,0,0,0,0,0,0,0
2022-12-05,Mon,0,0,0,0,0,0,0,0
2022-12-06,Tue,1,241.0,0,0,1,0,0,0
2022-12-07,Wed,32,565.0625,0,6,26,6,662.3333333333334,0
2022-12-08,Thu,6,1063.5,0,0,6,2,2080.5,0
2022-12-09,Fri,5,3204.8,0,0,5,5,1875.3333333333333,2
2022-12-10,Sat,18,1221.0555555555557,0,9,9,11,548.7,1
2022-12-11,Sun,0,0,0,0,0,0,0,0
2022-12-12,Mon,0,0,0,0,0,0,0,0
2022-12-13,Tue,0,0,0,0,0,0,0,0
2022-12-14,Wed,0,0,0,0,0,0,0,0
2022-12-15,Thu,2,2326.0,0,0,2,2,2790.5,0
2022-12-16,Fri,5,1175.8,0,0,5,2,1518.5,0
2022-12-17,Sat,12,1414.9166666666667,0,8,4,10,556.375,2
2022-12-18,Sun,0,0,0,0,0,0,0,0
2022-12-19,Mon,0,0,0,0,0,0,0,0
2022-12-20,Tue,2,2037.5,0,0,2,0,0,0
2022-12-21,Wed,13,992.4615384615385,0,12,1,13,542.1666666666666,1
2022-12-22,Thu,0,0,0,0,0,0,0,0
2022-12-23,Fri,0,0,0,0,0,0,0,0
2022-12-24,Sat,0,0,0,0,0,0,0,0
2022-12-25,Sun,0,0,0,0,0,0,0,0
2022-12-26,Mon,0,0,0,0,0,0,0,0
2022-12-27,Tue,0,0,0,0,0,0,0,0
2022-12-28,Wed,0,0,0,0,0,0,0,0
2022-12-29,Thu,0,0,0,0,0,0,0,0
2022-12-30,Fri,0,0,0,0,0,0,0,0
2022-12-31,Sat,0,0,0,0,0,0,0,0
2023-01-01,Sun,0,0,0,0,0,1,1492.0,0
2023-01-02,Mon,4,1732.0,0,0,4,1,7634.0,0
2023-01-03,Tue,0,0,0,0,0,0,0,0
2023-01-04,Wed,0,0,0,0,0,0,0,0
2023-01-05,Thu,0,0,0,0,0,0,0,0
2023-01-06,Fri,10,762.4,0,9,1,12,714.8333333333334,0
2023-01-07,Sat,0,0,0,0,0,0,0,0
2023-01-08,Sun,0,0,0,0,0,0,0,0
2023-01-09,Mon,0,0,0,0,0,0,0,0
2023-01-10,Tue,0,0,0,0,0,0,0,0
2023-01-11,Wed,0,0,0,0,0,0,0,0
2023-01-12,Thu,0,0,0,0,0,0,0,0
2023-01-13,Fri,0,0,0,0,0,0,0,0
2023-01-14,Sat,0,0,0,0,0,0,0,0
2023-01-15,Sun,1,1592.0,0,0,1,0,0,0
2023-01-16,Mon,0,0,0,0,0,0,0,0
2023-01-17,Tue,4,2818.75,0,0,4,0,0,0
2023-01-18,Wed,17,1093.8235294117646,0,16,1,18,645.3888888888889,0
2023-01-19,Thu,1,1074.0,0,0,1,2,647.0,0
2023-01-20,Fri,2,3979.5,0,0,2,0,0,0
2023-01-21,Sat,12,1474.4166666666667,0,9,3,11,579.6,1
2023-01-22,Sun,19,1206.157894736842,0,14,5,18,445.1764705882353,1
2023-01-23,Mon,0,0,0,0,0,0,0,0
2023-01-24,Tue,0,0,0,0,0,0,0,0
2023-01-25,Wed,0,0,0,0,0,0,0,0
2023-01-26,Thu,0,0,0,0,0,0,0,0
2023-01-27,Fri,1,2093.0,0,0,1,2,0,2
2023-01-28,Sat,10,1644.9,0,7,3,7,477.57142857142856,0
2023-01-29,Sun,9,998.7777777777778,0,9,0,9,522.0,0
2023-01-30,Mon,0,0,0,0,0,0,0,0
2023-01-31,Tue,0,0,0,0,0,0,0,0
2023-02-01,Wed,0,0,0,0,0,0,0,0
2023-02-02,Thu,38,384.4736842105263,0,0,38,2,0,2
2023-02-03,Fri,0,0,0,0,0,0,0,0
2023-02-04,Sat,29,1324.655172413793,0,11,18,16,636.4285714285714,2
2023-02-05,Sun,33,600.8181818181819,0,10,23,11,567.7,1
2023-02-06,Mon,0,0,0,0,0,6,1624.25,2
2023-02-07,Tue,0,0,0,0,0,2,563.0,0
2023-02-08,Wed,37,467.5405405405405,0,6,31,6,640.5,0
2023-02-09,Thu,0,0,0,0,0,1,0,1
2023-02-10,Fri,0,0,0,0,0,0,0,0
2023-02-11,Sat,26,1310.2307692307693,0,10,16,18,651.5555555555555,0
2023-02-12,Sun,28,390.89285714285717,0,1,27,2,573.5,0
2023-02-13,Mon,0,0,0,0,0,0,0,0
2023-02-14,Tue,0,0,0,0,0,0,0,0
2023-02-15,Wed,33,495.28125,1,6,27,8,731.25,0
2023-02-16,Thu,0,0,0,0,0,2,777.5,0
2023-02-17,Fri,0,0,0,0,0,0,0,0
2023-02-18,Sat,16,543.1875,0,0,16,0,0,0
2023-02-19,Sun,33,721.3333333333334,0,10,23,16,582.4615384615385,3
2023-02-20,Mon,0,0,0,0,0,0,0,0
2023-02-21,Tue,0,0,0,0,0,0,0,0
2023-02-22,Wed,5,1011.2,0,5,0,8,1235.875,0
2023-02-23,Thu,2,2204.0,0,0,2,0,0,0
2023-02-24,Fri,0,0,0,0,0,3,667.5,1
2023-02-25,Sat,11,824.2727272727273,0,9,2,11,427.09090909090907,0
2023-02-26,Sun,40,1407.5,0,12,28,15,558.6,0
2023-02-27,Mon,0,0,0,0,0,0,0,0
2023-02-28,Tue,0,0,0,0,0,3,1406.0,0
2023-03-01,Wed,0,0,0,0,0,0,0,0
2023-03-02,Thu,21,1165.0,0,8,13,13,584.1818181818181,2
2023-03-03,Fri,0,0,0,0,0,1,1661.0,0
2023-03-04,Sat,27,444.3703703703704,0,5,22,9,656.875,1
2023-03-05,Sun,18,1017.2222222222222,0,4,14,5,635.2,0
2023-03-06,Mon,0,0,0,0,0,2,2048.5,0
2023-03-07,Tue,0,0,0,0,0,0,0,0
2023-03-08,Wed,0,0,0,0,0,0,0,0
2023-03-09,Thu,0,0,0,0,0,0,0,0
2023-03-10,Fri,0,0,0,0,0,0,0,0
2023-03-11,Sat,13,1924.1538461538462,0,12,1,23,695.75,3
2023-03-12,Sun,5,950.25,1,4,1,7,571.0,0
2023-03-13,Mon,0,0,0,0,0,0,0,0
2023-03-14,Tue,0,0,0,0,0,0,0,0
2023-03-15,Wed,7,1083.0,0,4,3,5,732.4,0
2023-03-16,Thu,0,0,0,0,0,0,0,0
2023-03-17,Fri,0,0,0,0,0,3,1768.3333333333333,0
2023-03-18,Sat,0,0,0,0,0,3,414.6666666666667,0
2023-03-19,Sun,9,1506.111111111111,0,6,3,8,658.375,0
2023-03-20,Mon,0,0,0,0,0,0,0,0
2023-03-21,Tue,0,0,0,0,0,0,0,0
2023-03-22,Wed,0,0,0,0,0,0,0,0
2023-03-23,Thu,0,0,0,0,0,0,0,0
2023-03-24,Fri,0,0,0,0,0,1,4274.0,0
2023-03-25,Sat,0,0,0,0,0,0,0,0
2023-03-26,Sun,0,0,0,0,0,0,0,0
2023-03-27,Mon,23,3896.782608695652,0,18,5,26,1316.8846153846155,0
2023-03-28,Tue,0,0,0,0,0,0,0,0
2023-03-29,Wed,0,0,0,0,0,0,0,0
2023-03-30,Thu,0,0,0,0,0,0,0,0
2023-03-31,Fri,0,0,0,0,0,0,0,0
2023-04-01,Sat,5,540.6,0,4,1,5,759.0,0
2023-04-02,Sun,10,2654.875,2,7,3,10,530.5714285714286,3
2023-04-03,Mon,0,0,0,0,0,3,3201.0,1
2023-04-04,Tue,8,4287.625,0,0,8,5,4462.0,2
2023-04-05,Wed,2,1225.0,0,0,2,0,0,0
2023-04-06,Thu,0,0,0,0,0,0,0,0
2023-04-07,Fri,11,2658.0,9,0,11,8,5020.285714285715,1
2023-04-08,Sat,34,3472.6969696969695,1,7,27,13,791.8,3
2023-04-09,Sun,20,1634.0,0,16,4,17,1027.5294117647059,0
2023-04-10,Mon,0,0,0,0,0,0,0,0
2023-04-11,Tue,0,0,0,0,0,2,1188.5,0
2023-04-12,Wed,0,0,0,0,0,0,0,0
2023-04-13,Thu,0,0,0,0,0,2,13108.0,1
2023-04-14,Fri,0,0,0,0,0,2,2676.5,0
2023-04-15,Sat,10,3993.285714285714,3,0,10,5,5104.0,0
2023-04-16,Sun,16,1172.25,0,11,5,14,597.0714285714286,0
2023-04-17,Mon,13,1374.8333333333333,1,10,3,12,752.4545454545455,1
2023-04-18,Tue,2,998.0,0,2,0,5,776.8,0
2023-04-19,Wed,37,647.0285714285715,2,0,37,0,0,0
2023-04-20,Thu,11,1470.0,2,6,5,10,1203.375,2
2023-04-21,Fri,10,1258.6666666666667,1,8,2,11,688.9090909090909,0
2023-04-22,Sat,28,1013.75,0,6,22,10,641.7777777777778,1
2023-04-23,Sun,0,0,0,0,0,1,536.0,0
2023-04-24,Mon,6,1020.8333333333334,0,6,0,6,529.8333333333334,0
2023-04-25,Tue,15,2412.5,11,10,5,17,488.8333333333333,5
2023-04-26,Wed,30,1602.8846153846155,4,9,21,23,439.54545454545456,1
2023-04-27,Thu,0,0,0,0,0,3,3265.3333333333335,0
2023-04-28,Fri,2,1062.5,0,0,2,0,0,0
2023-04-29,Sat,28,1777.6785714285713,0,9,19,11,1039.7272727272727,0
2023-04-30,Sun,14,1522.2857142857142,0,0,14,2,8379.0,0
2023-05-01,Mon,21,1839.6666666666667,0,4,17,6,560.8,1
2023-05-02,Tue,22,1472.0454545454545,0,5,17,24,625.9090909090909,2
2023-05-03,Wed,54,3132.6415094339623,1,13,41,19,1197.3684210526317,0
2023-05-04,Thu,18,850.5,0,3,15,4,783.75,0
2023-05-05,Fri,0,0,0,0,0,0,0,0
2023-05-06,Sat,0,0,0,0,0,0,0,0
2023-05-07,Sun,30,2833.8,5,9,21,11,554.8888888888889,2
2023-05-08,Mon,14,227.57142857142858,0,0,14,0,0,0
2023-05-09,Tue,2,4144.5,0,0,2,0,0,0
2023-05-10,Wed,30,1189.1,0,0,30,1,10064.0,0
2023-05-11,Thu,12,697.3333333333334,3,2,10,6,841.3333333333334,3
2023-05-12,Fri,16,937.4375,0,9,7,11,665.7272727272727,0
2023-05-13,Sat,33,405.72727272727275,0,0,33,3,2832.0,1
2023-05-14,Sun,31,1461.5,1,6,25,11,2688.3636363636365,0
2023-05-15,Mon,14,3039.0,5,7,7,12,1699.111111111111,3
2023-05-16,Tue,19,5900.222222222223,1,10,9,38,1182.3055555555557,2
2023-05-17,Wed,50,1683.2340425531916,3,5,45,13,2105.0,2
2023-05-18,Thu,13,2780.5555555555557,4,1,12,4,12461.666666666666,1
2023-05-19,Fri,12,1195.2222222222222,3,8,4,9,1931.875,1
2023-05-20,Sat,33,3668.7894736842104,14,0,33,5,3222.0,1
2023-05-21,Sun,25,4761.866666666667,10,1,24,6,4702.0,4
2023-05-22,Mon,8,1425.7142857142858,1,3,5,4,620.3333333333334,1
2023-05-23,Tue,3,0,3,1,2,5,2300.6666666666665,2
2023-05-24,Wed,61,2402.1206896551726,3,15,46,23,2052.095238095238,2
2023-05-25,Thu,36,833.4166666666666,0,5,31,8,727.6666666666666,2
2023-05-26,Fri,28,4848.521739130435,5,9,19,12,644.0,3
2023-05-27,Sat,51,1024.5102040816328,2,9,42,17,927.4117647058823,0
2023-05-28,Sun,37,1454.1081081081081,0,5,32,7,890.4285714285714,0
2023-05-29,Mon,0,0,0,0,0,0,0,0
2023-05-30,Tue,22,588.0,0,20,2,22,370.90909090909093,0
2023-05-31,Wed,3,2653.6666666666665,0,0,3,1,0,1
2023-06-01,Thu,29,709.4827586206897,0,3,26,3,492.6666666666667,0
2023-06-02,Fri,24,1759.2916666666667,0,8,16,12,1932.5833333333333,0
2023-06-03,Sat,39,2670.4871794871797,0,19,20,29,791.7586206896551,0
2023-06-04,Sun,45,2329.088888888889,0,19,26,20,528.9473684210526,1
2023-06-05,Mon,25,1050.36,0,11,14,11,567.4545454545455,0
2023-06-06,Tue,24,439.125,0,0,24,0,0,0
2023-06-07,Wed,75,1162.7066666666667,0,11,64,13,544.5454545454545,2
2023-06-08,Thu,44,796.9090909090909,0,11,33,16,1390.9333333333334,1
2023-06-09,Fri,40,638.9,0,7,33,11,833.7272727272727,0
2023-06-10,Sat,44,1307.7058823529412,10,21,23,24,584.4545454545455,2
2023-06-11,Sun,5,0,5,0,5,1,0,1
2023-06-12,Mon,14,992.2142857142857,0,3,11,3,784.6666666666666,0
2023-06-13,Tue,27,3941.8846153846152,1,11,16,18,1277.9411764705883,1
2023-06-14,Wed,56,2906.5535714285716,0,15,41,28,1806.2,3
2023-06-15,Thu,51,5356.28,1,14,37,24,2437.2916666666665,0
2023-06-16,Fri,28,1074.9285714285713,14,14,14,19,470.2,4
2023-06-17,Sat,63,783.047619047619,0,6,57,9,1682.5555555555557,0
2023-06-18,Sun,20,518.5263157894736,1,3,17,5,972.25,1
2023-06-19,Mon,28,2476.0384615384614,2,3,25,3,574.0,0
2023-06-20,Tue,10,829.5,0,0,10,2,1713.0,0
2023-06-21,Wed,79,3235.8987341772154,0,14,65,22,1341.3,2
2023-06-22,Thu,23,2446.190476190476,2,11,12,12,639.4166666666666,0
2023-06-23,Fri,50,1073.42,0,8,42,12,631.0,1
2023-06-24,Sat,43,1891.3720930232557,0,8,35,12,715.25,0
2023-06-25,Sun,7,1092.4285714285713,0,2,5,3,947.5,1
2023-06-26,Mon,34,4743.294117647059,0,13,21,17,3625.6470588235293,0
2023-06-27,Tue,24,437.7916666666667,0,1,23,1,727.0,0
2023-06-28,Wed,47,365.5217391304348,1,1,46,1,451.0,0
2023-06-29,Thu,47,4865.765957446809,0,18,29,21,1221.2380952380952,0
2023-06-30,Fri,2,1101.0,0,0,2,0,0,0
2023-07-01,Sat,44,2417.8837209302324,1,7,37,12,1784.4,2
2023-07-02,Sun,42,2710.2894736842104,4,5,37,8,539.625,0
2023-07-03,Mon,10,560.2,0,0,10,2,1445.5,0
2023-07-04,Tue,20,817.3,0,6,14,14,897.7692307692307,1
2023-07-05,Wed,66,1509.8939393939395,0,10,56,11,695.0,0
2023-07-06,Thu,13,845.0,10,0,13,6,3087.0,2
2023-07-07,Fri,44,6351.952380952381,2,25,19,39,933.9375,7
2023-07-08,Sat,2,1054.0,0,1,1,2,502.5,0
2023-07-09,Sun,47,11119.634146341463,6,14,33,32,2863.689655172414,3
2023-07-10,Mon,0,0,0,0,0,0,0,0
2023-07-11,Tue,2,2398.5,0,0,2,0,0,0
2023-07-12,Wed,7,6943.428571428572,0,5,2,6,1043.5,0
2023-07-13,Thu,44,5944.209302325581,1,22,22,33,1121.4848484848485,0
2023-07-14,Fri,0,0,0,0,0,0,0,0
2023-07-15,Sat,1,1892.0,0,0,1,0,0,0
2023-07-16,Sun,1,3519.0,0,0,1,1,0,1
2023-07-17,Mon,23,1384.2608695652175,0,4,19,5,612.2,0
2023-07-18,Tue,22,854.4545454545455,0,1,21,7,1294.8,2
2023-07-19,Wed,43,1489.4285714285713,1,19,24,31,762.4074074074074,4
2023-07-20,Thu,47,3395.3829787234044,0,11,36,25,812.1363636363636,3
2023-07-21,Fri,33,889.6363636363636,0,6,27,12,938.2,2
2023-07-22,Sat,0,0,0,0,0,0,0,0
2023-07-23,Sun,13,827.8333333333334,1,0,13,1,622.0,0
2023-07-24,Mon,0,0,0,0,0,1,688.0,0
2023-07-25,Tue,29,4625.481481481482,2,14,15,25,2005.0416666666667,1
2023-07-26,Wed,53,2466.25,1,9,44,18,726.7058823529412,1
2023-07-27,Thu,45,682.8636363636364,1,3,42,8,597.0,2
2023-07-28,Fri,36,1019.0857142857143,1,7,29,14,609.4615384615385,1
2023-07-29,Sat,34,984.4117647058823,0,7,27,7,739.7142857142857,0
2023-07-30,Sun,23,637.0,0,2,21,4,1306.5,0
2023-07-31,Mon,9,372.8888888888889,0,0,9,0,0,0
2023-08-01,Tue,44,832.75,0,9,35,11,644.7272727272727,0
2023-08-02,Wed,0,0,0,0,0,0,0,0
2023-08-03,Thu,29,3468.3571428571427,1,19,10,25,597.48,0
2023-08-04,Fri,40,660.1282051282051,1,3,37,6,668.75,2
2023-08-05,Sat,0,0,0,0,0,0,0,0
2023-08-06,Sun,14,1684.2857142857142,0,7,7,12,1309.25,0
2023-08-07,Mon,40,8309.075,0,21,19,28,803.9629629629629,1
2023-08-08,Tue,8,379.625,0,0,8,0,0,0
2023-08-09,Wed,91,3013.6111111111113,1,21,70,28,1265.8076923076924,2
2023-08-10,Thu,22,1868.0454545454545,0,7,15,12,908.0,3
2023-08-11,Fri,38,5043.263157894737,0,15,23,23,528.1904761904761,2
2023-08-12,Sat,0,0,0,0,0,0,0,0
2023-08-13,Sun,2,1634.5,0,1,1,3,1397.0,1
2023-08-14,Mon,1,851.0,0,0,1,0,0,0
2023-08-15,Tue,64,10228.1875,16,23,41,55,1978.904761904762,13
2023-08-16,Wed,67,12033.98275862069,9,20,47,46,2052.75,10
2023-08-17,Thu,57,13675.489795918367,8,19,38,38,2552.516129032258,7
2023-08-18,Fri,0,0,0,0,0,0,0,0
2023-08-19,Sat,0,0,0,0,0,3,2229.6666666666665,0
2023-08-20,Sun,48,11482.386363636364,4,30,18,43,1569.047619047619,1
2023-08-21,Mon,28,3221.1785714285716,0,6,22,9,952.8888888888889,0
2023-08-22,Tue,34,4267.176470588235,0,15,19,17,650.6875,1
2023-08-23,Wed,63,1537.5901639344263,2,14,49,19,1434.7222222222222,1
2023-08-24,Thu,43,1754.4418604651162,0,19,24,26,1457.8260869565217,3
2023-08-25,Fri,27,3727.4444444444443,0,11,16,18,894.7333333333333,3
2023-08-26,Sat,38,692.3157894736842,0,0,38,4,629.0,3
2023-08-27,Sun,31,665.5483870967741,0,4,27,5,2173.2,0
2023-08-28,Mon,27,829.0833333333334,3,6,21,9,556.75,1
2023-08-29,Tue,11,1020.3636363636364,0,5,6,5,544.8,0
2023-08-30,Wed,52,1005.1730769230769,0,15,37,19,647.3157894736842,0
2023-08-31,Thu,24,729.25,0,5,19,6,707.0,1
2023-09-01,Fri,21,637.3809523809524,0,4,17,9,1002.8888888888889,0
2023-09-02,Sat,33,4395.090909090909,0,12,21,20,1266.5555555555557,2
2023-09-03,Sun,28,7052.178571428572,0,14,14,24,1252.7391304347825,1
2023-09-04,Mon,18,820.3888888888889,0,0,18,6,1086.5,0
2023-09-05,Tue,15,1709.9333333333334,0,2,13,11,1400.2727272727273,0
2023-09-06,Wed,49,762.3333333333334,1,3,46,11,842.4444444444445,2
2023-09-07,Thu,23,2365.0,0,4,19,13,2141.0,0
2023-09-08,Fri,19,889.5,1,8,11,16,738.75,4
2023-09-09,Sat,30,4986.214285714285,2,9,21,21,2170.4285714285716,0
2023-09-10,Sun,10,1948.3,0,1,9,8,2139.125,0
2023-09-11,Mon,11,602.0909090909091,0,1,10,4,484.75,0
2023-09-12,Tue,0,0,0,0,0,0,0,0
2023-09-13,Wed,78,2800.657894736842,2,14,64,19,696.6111111111111,1
2023-09-14,Thu,5,304.5,1,0,5,0,0,0
2023-09-15,Fri,38,4685.210526315789,0,18,20,20,676.9,0
2023-09-16,Sat,33,887.6060606060606,0,5,28,27,3954.25,11
2023-09-17,Sun,23,550.8260869565217,0,0,23,0,0,0
2023-09-18,Mon,0,0,0,0,0,0,0,0
2023-09-19,Tue,0,0,0,0,0,0,0,0
2023-09-20,Wed,0,0,0,0,0,0,0,0
2023-09-21,Thu,5,1505.8,0,0,5,1,664.0,0
2023-09-22,Fri,3,2157.0,0,0,3,4,2148.25,0
2023-09-23,Sat,46,2199.4565217391305,0,11,35,23,1198.4761904761904,2
2023-09-24,Sun,0,0,0,0,0,0,0,0
2023-09-25,Mon,18,2639.4444444444443,0,7,11,8,890.75,0
2023-09-26,Tue,3,304.3333333333333,0,0,3,1,1326.0,0
2023-09-27,Wed,0,0,0,0,0,2,2379.5,0
2023-09-28,Thu,39,548.0540540540541,2,3,36,4,552.3333333333334,1
2023-09-29,Fri,28,1367.6785714285713,0,5,23,10,1061.0,2
2023-09-30,Sat,40,689.75,0,6,34,7,574.1428571428571,0
2023-10-01,Sun,1,0,1,0,1,1,0,1
2023-10-02,Mon,8,503.625,0,2,6,2,651.0,0
2023-10-03,Tue,15,1247.0714285714287,1,3,12,6,2189.8,1
2023-10-04,Wed,38,760.3947368421053,0,7,31,7,823.0,0
2023-10-05,Thu,22,444.6818181818182,0,1,21,4,815.5,2
2023-10-06,Fri,8,311.375,0,0,8,2,0,2
2023-10-07,Sat,38,763.9459459459459,1,12,26,14,720.7857142857143,0
2023-10-08,Sun,38,896.9736842105264,0,5,33,6,2218.1666666666665,0
2023-10-09,Mon,25,1034.76,0,10,15,14,1065.4615384615386,1
2023-10-10,Tue,48,757.0416666666666,0,10,38,12,706.5,2
2023-10-11,Wed,0,0,0,0,0,0,0,0
2023-10-12,Thu,5,253.2,0,2,3,2,482.5,0
2023-10-13,Fri,0,0,0,0,0,2,1549.5,0
2023-10-14,Sat,37,1096.4864864864865,0,9,28,11,669.6363636363636,0
2023-10-15,Sun,42,837.3333333333334,0,8,34,9,899.0,0
2023-10-16,Mon,21,965.952380952381,0,7,14,13,1046.6666666666667,4
2023-10-17,Tue,28,1212.75,0,4,24,4,827.25,0
2023-10-18,Wed,0,0,0,0,0,0,0,0
2023-10-19,Thu,0,0,0,0,0,0,0,0
2023-10-20,Fri,0,0,0,0,0,0,0,0
2023-10-21,Sat,0,0,0,0,0,0,0,0
2023-10-22,Sun,45,782.7777777777778,0,6,39,14,1391.642857142857,0
2023-10-23,Mon,11,852.0909090909091,0,0,11,4,1137.3333333333333,1
2023-10-24,Tue,1,2536.0,0,0,1,0,0,0
2023-10-25,Wed,19,944.7894736842105,0,11,8,11,704.5454545454545,0
2023-10-26,Thu,5,3514.8,0,4,1,6,1023.3333333333334,0
2023-10-27,Fri,10,832.1,0,0,10,0,0,0
2023-10-28,Sat,1,3171.0,0,0,1,0,0,0
2023-10-29,Sun,35,646.0,0,8,27,9,883.1111111111111,0
2023-10-30,Mon,3,1370.6666666666667,0,0,3,0,0,0
2023-10-31,Tue,0,0,0,0,0,0,0,0
2023-11-01,Wed,1,7237.0,0,0,1,0,0,0
2023-11-02,Thu,0,0,0,0,0,0,0,0
2023-11-03,Fri,5,3757.6,0,0,5,1,3540.0,0
2023-11-04,Sat,0,0,0,0,0,0,0,0
2023-11-05,Sun,19,1327.0526315789473,0,15,4,17,667.8823529411765,0
2023-11-06,Mon,1,13568.0,0,0,1,1,0,1
2023-11-07,Tue,16,1259.75,0,13,3,15,610.4666666666667,0
2023-11-08,Wed,0,0,0,0,0,0,0,0
2023-11-09,Thu,7,1095.857142857143,0,5,2,6,542.1666666666666,0
2023-11-10,Fri,2,4782.0,0,0,2,3,518.3333333333334,0
2023-11-11,Sat,23,1407.695652173913,0,18,5,18,544.3333333333334,0
2023-11-12,Sun,0,0,0,0,0,0,0,0
2023-11-13,Mon,0,0,0,0,0,0,0,0
2023-11-14,Tue,1,5394.0,0,0,1,1,0,1
2023-11-15,Wed,23,958.3478260869565,0,19,4,22,522.9090909090909,0
2023-11-16,Thu,0,0,0,0,0,0,0,0
2023-11-17,Fri,15,1539.2,0,7,8,16,2532.75,0
2023-11-18,Sat,1,458.0,0,1,0,1,594.0,0
2023-11-19,Sun,0,0,0,0,0,0,0,0
2023-11-20,Mon,0,0,0,0,0,0,0,0
2023-11-21,Tue,0,0,0,0,0,0,0,0
2023-11-22,Wed,15,893.0,0,14,1,15,526.7333333333333,0
2023-11-23,Thu,0,0,0,0,0,0,0,0
2023-11-24,Fri,2,2092.0,0,0,2,0,0,0
2023-11-25,Sat,26,1589.7692307692307,0,20,6,21,656.9,1
2023-11-26,Sun,1,516.0,0,1,0,1,408.0,0
2023-11-27,Mon,0,0,0,0,0,0,0,0
2023-11-28,Tue,9,1504.2222222222222,0,2,7,2,971.5,0
2023-11-29,Wed,16,1752.1875,0,15,1,17,617.8235294117648,0
2023-11-30,Thu,4,720.3333333333334,1,0,4,1,0,1
2023-12-01,Fri,0,0,0,0,0,0,0,0
2023-12-02,Sat,0,0,0,0,0,0,0,0
2023-12-03,Sun,0,0,0,0,0,0,0,0
2023-12-04,Mon,0,0,0,0,0,0,0,0
2023-12-05,Tue,0,0,0,0,0,0,0,0
2023-12-06,Wed,19,1499.7894736842106,0,17,2,18,604.0588235294117,1
2023-12-07,Thu,0,0,0,0,0,0,0,0
2023-12-08,Fri,1,3076.0,0,0,1,0,0,0
2023-12-09,Sat,0,0,0,0,0,0,0,0
2023-12-10,Sun,0,0,0,0,0,0,0,0
2023-12-11,Mon,6,2193.3333333333335,0,3,3,3,975.6666666666666,0
2023-12-12,Tue,0,0,0,0,0,0,0,0
2023-12-13,Wed,0,0,0,0,0,0,0,0
2023-12-14,Thu,0,0,0,0,0,0,0,0
2023-12-15,Fri,4,985.25,0,0,4,0,0,0
2023-12-16,Sat,1,1834.0,0,0,1,0,0,0
2023-12-17,Sun,0,0,0,0,0,0,0,0
2023-12-18,Mon,0,0,0,0,0,0,0,0
2023-12-19,Tue,0,0,0,0,0,0,0,0
2023-12-20,Wed,9,1005.7777777777778,0,2,7,3,683.6666666666666,0
2023-12-21,Thu,0,0,0,0,0,0,0,0
2023-12-22,Fri,0,0,0,0,0,0,0,0
2023-12-23,Sat,0,0,0,0,0,0,0,0
2023-12-24,Sun,0,0,0,0,0,0,0,0
2023-12-25,Mon,0,0,0,0,0,0,0,0
2023-12-26,Tue,3,1774.3333333333333,0,0,3,1,4242.0,0
2023-12-27,Wed,0,0,0,0,0,0,0,0
2023-12-28,Thu,0,0,0,0,0,0,0,0
2023-12-29,Fri,1,947.0,0,0,1,0,0,0
2023-12-30,Sat,0,0,0,0,0,0,0,0
2023-12-31,Sun,0,0,0,0,0,0,0,0
2024-01-01,Mon,4,3654.0,0,0,4,0,0,0
2024-01-02,Tue,0,0,0,0,0,0,0,0
2024-01-03,Wed,0,0,0,0,0,0,0,0
2024-01-04,Thu,17,1099.235294117647,0,11,6,14,613.6428571428571,0
2024-01-05,Fri,1,566.0,0,0,1,0,0,0
2024-01-06,Sat,18,1469.2777777777778,0,13,5,14,628.2857142857143,0
2024-01-07,Sun,16,1546.1875,0,13,3,15,602.6,0
2024-01-08,Mon,2,2526.0,0,0,2,0,0,0
2024-01-09,Tue,3,1596.6666666666667,0,0,3,0,0,0
2024-01-10,Wed,18,1272.2777777777778,0,15,3,15,524.1333333333333,0
2024-01-11,Thu,1,886.0,0,0,1,0,0,0
2024-01-12,Fri,0,0,0,0,0,0,0,0
2024-01-13,Sat,20,1267.8,0,10,10,14,787.2857142857143,0
2024-01-14,Sun,24,1216.5,0,20,4,23,534.9047619047619,2
2024-01-15,Mon,3,1608.3333333333333,0,0,3,0,0,0
2024-01-16,Tue,4,1997.0,0,0,4,2,1225.0,0
2024-01-17,Wed,22,1285.409090909091,0,18,4,19,558.0526315789474,0
2024-01-18,Thu,11,1865.4545454545455,0,0,11,0,0,0
2024-01-19,Fri,6,3867.5,0,0,6,0,0,0
2024-01-20,Sat,0,0,0,0,0,0,0,0
2024-01-21,Sun,0,0,0,0,0,0,0,0
2024-01-22,Mon,0,0,0,0,0,0,0,0
2024-01-23,Tue,0,0,0,0,0,0,0,0
2024-01-24,Wed,15,318.06666666666666,0,0,15,0,0,0
2024-01-25,Thu,0,0,0,0,0,0,0,0
2024-01-26,Fri,8,2064.375,0,0,8,0,0,0
2024-01-27,Sat,50,557.62,0,5,45,5,582.8,0
2024-01-28,Sun,0,0,0,0,0,2,198.0,0
2024-01-29,Mon,1,2462.0,0,0,1,0,0,0
2024-01-30,Tue,0,0,0,0,0,0,0,0
2024-01-31,Wed,0,0,0,0,0,0,0,0
2024-02-01,Thu,25,1548.52,0,20,5,23,873.0952380952381,2
2024-02-02,Fri,0,0,0,0,0,2,2591.0,1
2024-02-03,Sat,18,401.3333333333333,0,0,18,0,0,0
2024-02-04,Sun,25,608.28,0,0,25,0,0,0
2024-02-05,Mon,0,0,0,0,0,0,0,0
2024-02-06,Tue,0,0,0,0,0,0,0,0
2024-02-07,Wed,17,1664.3529411764705,0,12,5,16,565.0,2
2024-02-08,Thu,0,0,0,0,0,0,0,0
2024-02-09,Fri,0,0,0,0,0,0,0,0
2024-02-10,Sat,0,0,0,0,0,0,0,0
2024-02-11,Sun,0,0,0,0,0,0,0,0
2024-02-12,Mon,7,1733.5714285714287,0,0,7,1,1700.0,0
2024-02-13,Tue,0,0,0,0,0,0,0,0
2024-02-14,Wed,0,0,0,0,0,0,0,0
2024-02-15,Thu,0,0,0,0,0,0,0,0
2024-02-16,Fri,3,2279.6666666666665,0,0,3,0,0,0
2024-02-17,Sat,0,0,0,0,0,0,0,0
2024-02-18,Sun,11,1154.8181818181818,0,10,1,10,598.8,0
2024-02-19,Mon,3,819.3333333333334,0,0,3,0,0,0
2024-02-20,Tue,0,0,0,0,0,0,0,0
2024-02-21,Wed,0,0,0,0,0,0,0,0
2024-02-22,Thu,0,0,0,0,0,0,0,0
2024-02-23,Fri,12,1209.0,0,11,1,11,657.0909090909091,0
2024-02-24,Sat,22,1367.5,0,19,3,19,540.7894736842105,0
2024-02-25,Sun,1,1039.0,0,0,1,1,306.0,0
2024-02-26,Mon,0,0,0,0,0,0,0,0
2024-02-27,Tue,0,0,0,0,0,0,0,0
2024-02-28,Wed,0,0,0,0,0,0,0,0
2024-02-29,Thu,0,0,0,0,0,0,0,0
2024-03-01,Fri,0,0,0,0,0,0,0,0
2024-03-02,Sat,0,0,0,0,0,0,0,0
2024-03-03,Sun,21,1544.047619047619,0,16,5,16,658.5625,0
2024-03-04,Mon,1,3274.0,0,0,1,2,1439.5,0
2024-03-05,Tue,5,1116.0,0,0,5,4,621.25,0
2024-03-06,Wed,3,2776.6666666666665,0,1,2,3,1192.3333333333333,0
2024-03-07,Thu,0,0,0,0,0,0,0,0
2024-03-08,Fri,2,2714.0,0,0,2,0,0,0
2024-03-09,Sat,7,1455.0,1,7,0,10,836.3333333333334,1
2024-03-10,Sun,0,0,0,0,0,0,0,0
2024-03-11,Mon,0,0,0,0,0,0,0,0
2024-03-12,Tue,0,0,0,0,0,0,0,0
2024-03-13,Wed,0,0,0,0,0,0,0,0
2024-03-14,Thu,0,0,0,0,0,0,0,0
2024-03-15,Fri,0,0,0,0,0,0,0,0
2024-03-16,Sat,6,9790.6,1,0,6,12,637.3333333333334,0
2024-03-17,Sun,0,0,0,0,0,1,2620.0,0
2024-03-18,Mon,0,0,0,0,0,0,0,0
2024-03-19,Tue,0,0,0,0,0,0,0,0
2024-03-20,Wed,0,0,0,0,0,0,0,0
2024-03-21,Thu,3,7044.333333333333,0,0,3,3,3119.6666666666665,0
2024-03-22,Fri,2,2079.5,0,0,2,0,0,0
2024-03-23,Sat,0,0,0,0,0,1,744.0,0
2024-03-24,Sun,8,10233.42857142857,1,0,8,9,1764.5555555555557,0
2024-03-25,Mon,0,0,0,0,0,0,0,0
2024-03-26,Tue,4,2167.75,0,0,4,0,0,0
2024-03-27,Wed,0,0,0,0,0,0,0,0
2024-03-28,Thu,0,0,0,0,0,0,0,0
2024-03-29,Fri,0,0,0,0,0,0,0,0
2024-03-30,Sat,15,8161.571428571428,1,0,15,9,2166.6666666666665,0
2024-03-31,Sun,3,1310.0,1,0,3,0,0,0
2024-04-01,Mon,3,2419.6666666666665,0,0,3,0,0,0
2024-04-02,Tue,2,3236.0,0,0,2,0,0,0
2024-04-03,Wed,0,0,0,0,0,0,0,0
2024-04-04,Thu,7,2786.714285714286,0,0,7,2,2457.5,0
2024-04-05,Fri,0,0,0,0,0,0,0,0
